1111111111
1000000001
1011110001
1000000001
1000000101
1000100001
1001000001
1000011001
1000000001
1111111111